{

    "rows": 12,
    "cols": 16,
    "tile_size": 40,
    "legend": {
        "GRASS": 0,
        "PATH": 1
    }
,
    "layout": [
        [0,0,0,0,0,0,0,0,0,0,0,0,0,0,0,0],
        [0,0,0,0,0,0,0,0,0,0,0,0,0,0,0,0],
        [0,0,0,0,0,0,0,0,0,0,0,0,0,0,0,0],
        [1,1,1,0,0,0,0,0,0,0,0,0,0,0,0,0],
        [1,0,1,0,0,0,0,0,0,0,0,0,0,0,0,0],
        [1,0,1,1,0,1,1,1,1,1,1,1,1,1,1,1],
        [0,0,0,1,0,1,0,0,0,0,0,0,0,0,0,0],
        [0,0,0,1,0,1,0,0,0,0,0,0,0,0,0,0],
        [0,0,0,1,0,1,0,0,0,0,0,0,0,0,0,0],
        [0,0,0,1,1,1,0,0,0,0,0,0,0,0,0,0],
        [0,0,0,0,0,0,0,0,0,0,0,0,0,0,0,0],
        [0,0,0,0,0,0,0,0,0,0,0,0,0,0,0,0]
    ]
}